Category,ItemCode,ItemName,ItemTier,Item Description,PurchaseCost,Height,Width,Weight,PhysicalDamage,MagicalDamage,PoiseDamage,AttackSpeed
ID_0_Bat,0,Unequip,0,장착된 무기 없음,0,0,0,0,0,0,0,1
ID_0_Bat,1,,,,,,,,0,0,0,1
ID_0_Bat,2,,,,,,,,0,0,0,1
ID_0_Bat,3,,,,,,,,0,0,0,1
ID_0_Bat,4,,,,,,,,0,0,0,1
ID_0_Bat,5,,,,,,,,0,0,0,1
ID_0_Bat,6,,,,,,,,0,0,0,1
ID_0_Bat,7,,,,,,,,0,0,0,1
ID_0_Bat,8,,,,,,,,0,0,0,1
ID_0_Bat,9,,,,,,,,0,0,0,1
ID_1_Axe,10,,,,,,,,0,0,0,1
ID_1_Axe,11,,,,,,,,0,0,0,1
ID_1_Axe,12,,,,,,,,0,0,0,1
ID_1_Axe,13,,,,,,,,0,0,0,1
,14,,,,,,,,0,0,0,1
,15,,,,,,,,0,0,0,1
,16,,,,,,,,0,0,0,1
,17,,,,,,,,0,0,0,1
,18,,,,,,,,0,0,0,1
,19,,,,,,,,0,0,0,1
,20,,,,,,,,0,0,0,1
,21,,,,,,,,0,0,0,1
,22,,,,,,,,0,0,0,1
,23,,,,,,,,0,0,0,1
,24,,,,,,,,0,0,0,1
,25,,,,,,,,0,0,0,1
,26,,,,,,,,0,0,0,1
,27,,,,,,,,0,0,0,1
,28,,,,,,,,0,0,0,1
,29,,,,,,,,0,0,0,1
,30,,,,,,,,0,0,0,1
,31,,,,,,,,0,0,0,1
,32,,,,,,,,0,0,0,1
,33,,,,,,,,0,0,0,1
,34,,,,,,,,0,0,0,1
,35,,,,,,,,0,0,0,1
,36,,,,,,,,0,0,0,1
,37,,,,,,,,0,0,0,1
,38,,,,,,,,0,0,0,1
,39,,,,,,,,0,0,0,1
,40,,,,,,,,0,0,0,1
,41,,,,,,,,0,0,0,1
,42,,,,,,,,0,0,0,1
,43,,,,,,,,0,0,0,1
,44,,,,,,,,0,0,0,1
,45,,,,,,,,0,0,0,1
,46,,,,,,,,0,0,0,1
,47,,,,,,,,0,0,0,1
,48,,,,,,,,0,0,0,1
,49,,,,,,,,0,0,0,1
ID_5_Mace,50,,,,,,,,0,0,0,1
ID_5_Mace,51,,,,,,,,0,0,0,1
ID_5_Mace,52,,,,,,,,0,0,0,1
ID_5_Mace,53,,,,,,,,0,0,0,1
,54,,,,,,,,0,0,0,1
,55,,,,,,,,0,0,0,1
,56,,,,,,,,0,0,0,1
,57,,,,,,,,0,0,0,1
,58,,,,,,,,0,0,0,1
,59,,,,,,,,0,0,0,1
,60,,,,,,,,0,0,0,1
,61,,,,,,,,0,0,0,1
,62,,,,,,,,0,0,0,1
,63,,,,,,,,0,0,0,1
,64,,,,,,,,0,0,0,1
,65,,,,,,,,0,0,0,1
,66,,,,,,,,0,0,0,1
,67,,,,,,,,0,0,0,1
,68,,,,,,,,0,0,0,1
,69,,,,,,,,0,0,0,1
,70,,,,,,,,0,0,0,1
,71,,,,,,,,0,0,0,1
,72,,,,,,,,0,0,0,1
,73,,,,,,,,0,0,0,1
,74,,,,,,,,0,0,0,1
,75,,,,,,,,0,0,0,1
,76,,,,,,,,0,0,0,1
,77,,,,,,,,0,0,0,1
,78,,,,,,,,0,0,0,1
,79,,,,,,,,0,0,0,1
,80,,,,,,,,0,0,0,1
,81,,,,,,,,0,0,0,1
,82,,,,,,,,0,0,0,1
,83,,,,,,,,0,0,0,1
,84,,,,,,,,0,0,0,1
,85,,,,,,,,0,0,0,1
,86,,,,,,,,0,0,0,1
,87,,,,,,,,0,0,0,1
,88,,,,,,,,0,0,0,1
,89,,,,,,,,0,0,0,1
,90,,,,,,,,0,0,0,1
,91,,,,,,,,0,0,0,1
,92,,,,,,,,0,0,0,1
,93,,,,,,,,0,0,0,1
,94,,,,,,,,0,0,0,1
,95,,,,,,,,0,0,0,1
,96,,,,,,,,0,0,0,1
,97,,,,,,,,0,0,0,1
,98,,,,,,,,0,0,0,1
,99,,,,,,,,0,0,0,1
